####################
#                  #
#                  #
#                  #
#                  #
#                  #
#                  #
#       #######    #
#       #     #    X
#       #  #  #    #
#       #  #  #    #
#       ####  #    #
#                  #
#           S      #
#                  #
#                  #
#                  #
#                  #
#                  #
####################