####################
#                  #
# ############ ### #
# # #  ####  #   # #
# #    #       # # #
# # ####### ###### #
# #   #            #
# # ### ####### ####
#     #   #     #  X
## #     ## ###### #
## # ###       # # #
## # #S# ## #### # #
## # # #  #      # #
## #   # ## ###### #
## ##### #   #     #
#        # ##### ###
# #### # #       # #
# ###### #### #### #
#                  #
####################