##########
#        #
# S #### #
#   #  # #
#   #  # #
#   # ## #
#   # #  #
#   # #  #
#   ######
#        X
##########