##########
#        #
#  ####  #
#  #  #  #
#  #  #  #
X  ####  #
#        #
#    S   #
##########